ssssssssssssssssssssssssssssssssssssssssss
s                                        s
s                                        s
s                                        s
s          rsppppppppppppppppsl          s
s         rs                  sl         s
s        rs                    sl        s
s       rs                      sl       s
s      rs                        sl      s
s     rs                          sl     s
s    rs                            sl    s
s   rs              @               sl   s
sppps                                sppps
s                                        s
s                                        s
s                                        s
s                                        s
spppppppppppppppppppppppppppppppppppppppps
s                                        s
s                                        s
s                                        s
s                                        s
spppsl                              rsppps
s    sl                            rs    s
s     sl                          rs     s
s      sl                        rs      s
s       sl                      rs       s
spp      sl                    rs      pps
s         sl                  rs         s
s          sl                rs          s
s           spppppppppppppppps           s
s                                        s
s                                        s
s                                        s
ssssssssssssssssssssssssssssssssssssssssss