ssssssssssssssssssssssssssssssssssssssssssssssssssssssssssssss
s                          s                                 s
s                          s                                 s
s                          s                                 s
spppsssssssssssssssssssspppspppsssssssssssssssssssssssssspppps
s   s                                 s                      s
s   s                                 s                      s
s   s                                 s                      s
spppspppssssssssssssssssssssssssssssssssssspppssssssssssssssss
s                                         s   s              s
s                                         s   s              s
s                                         s   s              s
ssssssssssssssssppppppppppppssssssssssssssspppssssssppppssssss
s                                         s   s              s
s                                @        s   s              s
s                                         s   s              s
spppppppssssssssssssssssssssssssssspppppppspppssssssssssssppps
s              s          s                                  s
s              s          s                                  s
s              s          s                                  s
sssssssssssspppssssppppssssssppppsssssssssssssssssssssssssssss
s          s                       s                         s
s          s                       s                         s
s          s                       s                         s
sppppsssssssssssppppppppppppssssssssssssssspppssssssssssssssss
s                                                            s
s                                                            s
s                                                            s
ssssssssssssssssssssssssssssssssssssssssssssssssssssssssssssss