sssssssssssssssssssssssssssssssssssssssss
s                                       s
s                                       s
s                                       s
s                                       s
s                                       s
s                                       s
s            rssssssssssssssss          s
s           rs                          s
s          rs                           s
s         rs                            s
s        rssssss         ssl            s
s       rs                 sl           s
sssssssssssssssssssssssssssssssssssssssss